8 8
########
#.....1#
#@.....#
#A.....#
#......#
#......#
#......#
########
